946
_______________________________________________
ललचायो : भूक००कए । लालच में पड़ गया, लोभ में डाला गया । 'नाथ, हाथ कछु नहिं लग्यो, लालच ललचायो ।' विन० २७६.४
ललन : लला। लाल, दुलारा-दुलारे, प्रिय पुत्र। 'छोड़ो मेरे ललित ललन लरिकाई ।' कृ० १३
ललना : (१) ललन । 'मातु दुलराइ कहि प्रिय ललना ।' मा० १.१६८.८ (२) संस्त्री० (सं.)। सुन्दरी, स्त्री। मा० १.३२२ ‘ऐसी ललना सलोनी ।' गी० २.२१.१
लला : लाल (सं० लाल्यक>प्रा० लल्लअ) । प्रिय बेटा । 'बलि जाउँ लला इन बोलन की।' कवि० १.५ '
लला, ललाइ, ई : आ०ए० (सं० लालायते>प्रा. लालाइ)। लार टपकाता है, ललचाता है; तरसता है । 'ककर ट्रकन लागि ललाई ।' कवि० ७.५७
ललाइ : पूकृ० । लल्ला कर, तरस कर । 'मरतो.''लटि लालची ललाइ के ।' गी० ५.२८.८
ललाट : सं०पू० (सं०) । मस्तक । मा० १.१४७.४
ललात : वकृ.पु । तरसता-ते । 'पानी को ललात बिललात ।' कवि० ५.१६
ललाम, ललामा : सं+वि० (सं०) । (१) सुन्दर, उत्तम, ललित । 'परम सुदरी नारि ललामा ।' मा० १.१७८.२ (२) रत्न । 'मनहुं पुरट संपुट लसत तुलसी ललित ललाम ।' दो० ७ (३) आभूषण। 'चंद्रललाम' =चन्द्रभूषण (शिव) । पा०म० छं० ४
ललामु : ललाम+कए० । अद्वितीय रत्न । 'राम नाम ललित ललाम कियो लाखनि को।' कवि० ७.६८
ललामो : ललाम । 'गुंजनि जितो ललामो ।' विन० २२८.४
ललित : वि० (सं.)। विलासपूर्ण, मोहक, सुन्दर, कोमल । मा० १.४३.१
ललिताई : सं०स्त्री० । लालित्य, छविविलास, मनोहरता। 'इंदिरा अधिक ललिताई।' विन० ६२.१२
लल्लाट : ललाट । विन० ११.३
लव : सं०पु० (सं.)। (१) खण्ड, अंश, लेश । 'जो सुख लव सतसंग ।' मा० ५.४ (२) क्षण; पलक मारने के समय (पल) का छठा भाग । 'लव निमेष परमानु जुग ।' मा० ६ दोहा १ (३) राम का छोटा पुत्र । 'लव कुस बेद पुरानन्हि गाए ।' मा० ७.२५.६
लवन : सं०० (सं० लवण)। लोन, क्षार, नमक । मा० २.६३.६
लवनि, लवनी : संस्त्री० । अन्न के रूप में दी जाने वाली सस्य की कटाई की मजदूरी । 'रूपरासि बिरची बिरंचि मनो सिला लवनि रति काम लही री।' गी० १.१०६.४
947
लवलेस, लवलेसा : (सं० लव-लेश खण्ड का खण्ड) । क्षुद्र कण, अल्पतम अंश | मा० ५.२१ 'नहिं तह मोह निसा लवलेसा ।' मा० १.११६.५
लवलेसु, लवलेसू : लवलेस+कए० । मा० २.३०३.५
लवा : सं०पू० (सं० लवक>प्रा० लवअ) लावा । बटेर पक्षी । 'बाज झपट जन लवा लुकाने ।' मा० १.२६८.३
लवाइ : (१) पूक० । लिवा कर, साथ लेकर । 'सादर चली लवाइ ।' मा० १.२४६ (२) लवाई । शीघ्र ब्याई हुई। 'हुंकरि हुंकरि सुलवाइ धेनु जिमि धावहिं ।' पा०म० १०३
लवाई : (१) लवाइ। साथ लेकर । 'जा दिन तें मुनि गए लवाई।' मा० १.२६१.७ (२) भूकृ. स्त्री०। साथ ले जाई गयी। (३) शीघ्र ब्याई हुई। 'बाल बच्छ जनु धेनु लवाई।' मा० १.३३७.८ (संस्कृत में 'लाविका' भैस के अर्थ में है-उसी का रूपान्तर तथा अर्थान्तर जान पड़ता है)।
लवे : आ०प्रए० (सं० लू छेदने) फसल काटता है, काट सकता है (फल पाता है)।  'बर्व सो लवं निदान ।' वैरा० ५
लस, लसइ, ई : आ.प्रए० (सं० लसति-लस कान्तौ>प्रा० लसइ)। शोभित होता है, दीप्ति बिखेरता-ती है। 'लस मसि बिंदु बदन बिधु नीको।' गी. १.२४.६ 'जन मधु मदन मध्य रति लसई ।' मा० २.१२३.३
लसत : वकृ.पु । दीप्त होता-होते । 'लसत स्वेद कन जाल ।' मा० २.११५
लसति : वकृ०स्त्री० । प्रकट होती । 'मति लसति बिषय लपटानि ।' दो० २५३
लसद् : लसत (सं०) । सुशोभित होता हुआ। मा० ७.१०८.३
लसम : वि० अल्प, अकिंचन । ‘लसम के खसम तुहीं पं दसरथ के ।' कवि० ७.२४
लसहिं : आ०प्रब० (अ.) । दमकते हैं। 'रद लसहिं, दमक जनु दामिनि ।'  जा मं० ७२
लसी : भूकृ०स्त्री० । शोभित हुई, चमकी । 'मानों प्रतच्छ परब्बत की नभ लीक ___ लसी।' कवि० ६.५४
लसे : भूक०० ब० (सं० लसित >प्रा० लसिय) । शोभित हुए। पिसाच पसुपति संग लसे ।' पा०म०छं० १२
लसैं : लसहिं । द्वै द्वै दंतुरियां लसें ।' गी० १.३३.४
लसै : लसइ । कवि० ७.१३८
लस्यो : भूकृ००कए० । दीप्त हो उठा, चमक चला । 'सरीरु लस्यो तजि नीरु ज्यों कोई ।' कवि० २.२ '
लह, लहइ, ई : आ.प्रए० (सं० लभते>प्रा० लहइ) । (१) पाता है, पा सकता है। 'तासु बिमुख किमि लह बिश्रामा ।' मा० ६.३५.६ सुभ गति लहइ।' मा. ३.५ 'अकलंकता कि कामी लहई ।' मा० १.२६७.३ (२) संगत होता है, शोभा पाता है, उचित होता है। 'सेवकु लहइ स्वामि सेवकाई ।' मा० २.६.८ 'भलो भलाइहि प ल हइ लहइ निचाइहि नीचु ।' मा० १.५
लहउँ, ॐ : आ० उए० (सं० २.भे>प्रा० लहमि>अ० लहउँ) । पाऊँ, पा सकता हूं, पाता हूं। 'बाढ़इ कथा पार नहिं लहऊँ ।' मा० १.१२.३
लहकी : भूकृ०स्त्री० । लहक उठी, वायु में दमदमा उठी, लपलपा उठी। 'लहकी कपि लंक जथा खर-खौकी ।' कवि० ७.१४३
लहकोरि : संस्त्री० (सं० लघुकवल) । विवाह संस्कार के तुरन्त बाद कोहबर में  वर वधू को परस्पर ग्रास देने की प्रथा । मा० १.३२७ छं० २
लहत : व.पु. । पाता-पाते। मा० १.५.७
लहति : वकृस्त्री० । पाती । 'उपमा कहुं न लहति मति मोरी।' मा० १.१०५.२
लहते : क्रियाति०० ब० । यदि 'तो.."पाते । 'जो पं हरि जन के औगुन गहते... तो.. सपनेहुं सुगति न ल हते ।' विन ० ६७.१-५
लहतो : क्रियाति०पू०ए० । पाता । 'चाहतो जो जोई जोई लहतो सो सोई सोई। विन० २४६.२
लहब : भकृ०० (सं० लब्धव्य>प्रा० लहिअव्व) । पाना (होगा) । 'सो फल तुरत लहब सब काहूँ।' मा० १.६४.२
लहरि : सं० स्त्री० (सं०) । (१) तरङ्ग । (२) सर्प-विष चढ़ने पर होने वाली कायिक कम्प तथा अकड़न के साथ झमने की क्रिया । 'संसय सर्प असेउ मोहि भ्राता । दुखद लहरि कुतर्क बहु ब्राता ।' मा० ७.६३.६
लहलहात : वकृ०० । लहकते, लहराते । 'लहलहात जनु ब्याल ।' मा० ६.६१
लहलहे : भूकृ.पु । लहराते हुए, चपल-प्रसन्न । 'लहलहे लोयन सनेह सरसई । गी० १.६६.२
लहसुन : सं०० (सं० लशुन) । दो० ३५५
लहहिं, लहहीं : आ०प्रब० । (१) पाते हैं । 'उपजाहिं अनत अनत छबि लहहीं।' मा० १.११.३ (२) पायें, पा सकें । लहहिं लोग सब लोचन लाडू ।' मा० २.४.३
लहहुं : आ०-आशंसा, कामना-प्रब० । प्राप्त करें। 'लोग 'लहहं बिश्राम ।" मा० २.२४८
लहा : भूकृ०० (सं० लब्ध>प्रा० लहिअ)। पाया। 'संत कहंत जे अंत लहा है।" कवि० ७.३६
लहि : (१) पूकृ० । प्राप्त कर । 'मुदित भए लहि लोचन लाहु ।' मा० २.१०८.७. (२) लही । प्राप्त की । 'लहि जन रंकन्ह सुरमनि ढेरी ।' मा० २.११४.५ (३) लगि । पर्यन्त , तक । 'उलटउँ महि जहँ लहि तव राजू ।' मा० १.२७०.४
949
लहिअ : आ०कवा०प्रए० (सं० लभ्यते>प्रा० लहीअइ) । पाया जाता है, पाया जा ___ सकता है । 'बवा सो लुनिअ लहिअ जो दीन्हा ।' मा० २.१६.५
लहिबे : भक०० । पाने (योग्य),प्राप्य । “गति परमिति लहिवे ही।' ४०
लहिबो : भकपु०कए० (सं० लब्धव्यम् >प्रा. लहिअव्वं>अ. लहिव्व उ) । पाना (होगा) । परम मुद मंगल लहिबो ।' गी० ५.१४.३
लहियतु : वकृ०-कवा०-०कए० (सं० लभ्यमानम् >प्रा० लहीअंत>अ० लहीअंतु) । प्राप्त होता । 'राजपूतु पाए हूँ न सुखु लयितु है ।' कवि० २.४
लहिहैं : आ०भ० उब० । हम प्राप्त करेंगे-गी। 'फल जीवन आपन तो लहिहैं ।' कवि० २.२३
लहिहौं : आ० भ० उए । पाऊँगा-गी। 'हौं लहिहौं सखु राजमातु व ।' गी० २.६०.३
लहीं : लही+ब० । प्राप्त की। 'ते परितोष उमा रमा लहीं ।' गी० १.५.६
लही : भूक०स्त्री० । प्राप्त की। 'सब सन लही असीस ।' मा० १.३२०
लहु : लघु (प्रा.) । अल्प । 'बड़ी आस लहु लाहु ।' रा०प्र० ७.५.१
लहे : भूकृ०पुब० । प्राप्त किये । तिन्ह हरष सख अगनित लहे।' मा० ७.६ छ।
लहेउँ : आ०-भूकृ०पु+उए० । मैंने पाया । 'लहेउ आज जग जीवन लाहू।' मा० १.३३१.४
लहेउ, लहेऊ : भूकृ.पु.कए० । पाया । मा० १.४६.८ 'राजां मुदित महासुख लहेऊ ।' मा० १.२४४.८
लहैं : लहहिं । पायें, पाते हैं । 'फलु सब लहैं ।' मा० १.३२७ छं० २
लहै : लहइ । (१) पाता है । 'बास नासिका बिन लहै ।' वैरा० ३ (२) पा जाय, प्राप्त करे । 'सुरतरु लहै जनम कर भूखा।' मा० १.३३५.५
लहैगो : आ०भ०पू०प्रए० । पायेगा । आपनी भलाई थल कहाँ कौन लहैगो।' विन० २५६.३
लहो : लह्यो । 'नाहिन काहू लहो सुख ।' क० ५४
लहौं : लहउँ । पाता हूं, पाऊँ । 'कहुं न कृपानिधि सो लहौं ।' विन २२२.१
लहौंगो : आ०म०पू० उए । पाऊंगा । परसें पद पापु लहौंगो ।' कवि० ७.१४७
लह्यो : लहेउ । पारु कवि कोने ल ह्यो।' मा० १.३६१ छं० •
लाँघत : वकृ०० (सं० लङ्घयत् >प्रा० लंघेत) । कूदकर पार जाता-जाते । ___कोउ लाँघत कोउ उतरत थाहैं ।' गी० ७.१३.१
लाँधि : लंधि । 'लाँघि गए हनुमान ।' दो० ५२८
लाँध्यो : लंघेउ। गी० ५.१६.२
लाँबी : वि०स्त्री० । लम्बी, दीर्घ । 'लांबी लूम लसत ।' कवि० ६.४०
950

लांछन : सं०पु० (सं.)। चिह्न। 'भ्राज श्रीवत्प लांछन उदारं ।' विन० ६१.५
लाइ : (१) पूक० । लगाकर । लिपटा कर । 'बहुरि लाइ.उर लीन्ह कुमारी।' मा०. १.१०२.४ (२) लेकर । 'कहों कोन मुह लाइ के ।' विन० १४८.१
लाइअ : आ० कवा०प्रए० । लगाइए । 'बेगिअ नाथ न लाइअ बारा ।' मा० २.५.७
लाइन्हि : आ०-भकृ+प्रब । उन्होंने लगाये । 'हाट पटोरन्हि छाइ सफल तरु लाइन्हि ।' पामं० ८७
लाइयत : वक०कवा०पू० । लगाया जाता । 'बबुर बहेरे को बनाइ बागु लाइयत । कवि० ७.६
लाइयो : लायउ। लगाया, लिपटाया। 'भरत ज्यों उर लइयो ।' मा० ६ १२१ छं० २
लाइहैं : आ०भ०प्रब० । लगा देंगे । 'हाथ लंका लाइहैं तो रहेगी हथेरी सी ।' कवि ६.१०
लाइहौं : आ०भ० उए । लगाऊंगा । 'कृपानिकेत पद मन लाइहौं ।' मा० ३.२६ छं०.
लाईं : लाई+ब० । लगायी, लिपटायीं। 'रानिन्ह बार-बार उर लाई।' मा.. १.३३४.७
लाई : (१) भूकृ० स्त्री० । लगा दी । 'मानहुं मघा मेघ झरि लाई।' मा० ६.७३.३३ (२) जला दी। 'ख्याल लंका लाई कपि राड़ की सी झोपरी ।' कवि० ६.२७, (३) लाइ। लगाकर । 'सुनिहहिं बाल बचन मन लाई।' मा० १.८.५ (४) आधार मान कर । 'राखेउँ प्रान जानकिहि लाई।' मा० २.५६.२ (५) लेकर । 'देहउँ उतरु कौनु महु लाई ।' मा० २.१४६.७
लाउब : भकृ.पुं० । लाना (होगा) (लाएँगे) । 'तिन्ह निज ओर न लाउब भोरा ।" मा० १.५.१
लाएँ : (१) क्रि०वि० । लगाकर । 'साधक नाम जपहिं लय लाएँ।' मा० १.२२.४ः (२) ओर । 'लखन चलहिं मगु दाहिन लाएँ।' मा० २.१२३.६
लाए : भूकृ००० । लगाये । 'मुनिबर उर लाए।' मा० १.३०८.५
लाकरी : लकड़ी । 'पावक परत निषिद्ध लाकरी होति अनल जग जानी ।' कृ० ४८
लाख : लक्ख । 'आकर चारि, लाख चौरासी।' मा० १.८.१।।
लाखन : लाख+संब० । लाखों। 'ते रन तिक्खन लवखन लाखन दानि ज्यों दारिद दाबि दले हैं ।' कवि० ६.३३
लाखनि : लाखन ! कवि० ७.६८
लाग : (१) लागइ । लगता है, प्रतीत होता है । निज कबित्त के हि लाग न नीका।" मा० १.८.११ (२) भूकृ०० (सं० लग्न >प्रा० लङ्ग)। लगा, सं.सक्त हुआ, प्रभाव डाल सका । 'लाग न उर उपदेसु ।' मा० १.५१ (३) सं०० (सं०)। सहारा।
लाग, लागह, ई : लगइ। (१) संलग्न होता है। 'फल ... बबू रहिं लागई।' मा० १.६६ छं० (२) प्रतीत होता-ती है । 'लागइ लघु बिरंचि निपुनाई।' मा० १.६४.८ (३) आहत करता है, विकार उत्पन्न करता है । 'लागइ अति पहार कर पानी ।' मा० २.३३.२ (४) संचित होता है। कहत न लागइ ढेर।' दो० ४३७
लागउँ : आउए । लगता हूं (मस्तक से स्पर्श करता हूं)। 'बार बार पद लागउँ।' मा० ५.३६
लागत : लगत । (१) प्रतीत होता-होते । 'प्रानहूँ ते प्रिय लागत ।' मा० १.२०४ (२) संसक्त होते । 'चिक्करत लागत बान ।' मा० ३.२०.१०
लागति : लगति । लगती, प्रतीति होती। 'लागति अवध भयावनि भारी।' मा० २.८३..
लागते : क्रियाति००० । यदि लगते, प्रतीत होते । 'जो मोहि राम लागते मीठे।' विन० १६६.१
लागहिं : लगहिं । लगते हैं। (१) संपक्त होते हैं । 'लाहिं सैल वज्र तन तासू ।' मा० ६.८२.३ छं० (२) प्रतीत होते हैं। 'सजन सगे प्रिय लागहिं जैसें ।' मा० १.२४२.२
लागहु : आ०मब० । लगो। (१) स्पर्श करो। 'मुनि पद लागह सकल सिखाए।' मा० ७.८.५ (२) प्रतीत होओ। 'प्रिय लागहु मोहि राम ।' मा० ७.१३०
लागा : भूकृ.पु० । लगा। (१) संसक्त हुआ। 'बिसरी देह तपहिं मनु लागा।' मा० १.७४.३ (२) आरम्भ किया। 'पुनि रघुपति से जूझ लागा।' मा० ६.७३.१०
लागि : (१) भूकृ०स्त्री० । लगी। (१) एकाग्र हुई । 'लागि समाधि ।' मा० १.५८.८ (२) संपृक्त हुई । 'लागि लागि आगि ।' कवि० ५ (३) लागे । लगे हुए । 'लागि देखि सुदर फल रूखा।' मा० ५.१७.७ (४) पू० प्रयोजनार्थक । लिए, हेतु । 'तुम्ह जेहि लागि बज्र पुर पारा।' मा० २.४६.८ (५) आ०- आज्ञा-मए० । तू लग, उलझ। 'बार बार कह्यो पिय कपि सों न लागि रे ।' कवि० ५.६
लागिअ : आ०कवा०प्रए० । लगा जाय, घेर कर स्थित हआ जाय, घेरा डाला जाय। 'लंका बाँके चारि दुआरा । केहि बिधि लागिअ करहु बिचारा।' मा० ६३६.२
लागिहि : आ०भ० प्रए० (सं० लगिष्यति>प्रा० लग्गिहिइ)। लगेगा-गी। (१) प्रतीत होगा-होगी । 'तिन्हहि कथा सुनि लागिहि फीकी ।' मा० १.६.५ (२) सफल होगी । इहाँ न लागिहि राउरि माया।' मा० २.३३.५ (३) प्राप्त होगा । 'नहिं लागिहि कछु हाथ तुम्हारे ।' मा० २.५०.५ (४) होगा-होगी। दिवस जात नहिं लागिहि बारा ।' मा० २.६२.२ (५) छएगा-गी। 'लागिहि तात बयारि न मोही ।' मा० २.६७.६
लागिहै : लागिहि । लगेगा-गी। (१) संपृक्त होगी। 'तिन्ह के मुहँ मसि लागिहै ।' दो० ३८६ (२) अनुरक्त (तल्लीन) होगा । 'रघुबरहि कबहुं मन लागिहै ।' विन० २२४.१ (३) उलझेगा । 'चित्रहू के कपि सो निसाचरु न लागिहै ।' कवि० ५.१४ (४) मए । तू लगेगा, सहमत होगा । 'मलो भली भाँति है जो मेरे कहे लागिहै ।' विन० ७०.१
लागिहौ : आ०भ०मब० । लगोगे (प्रतीत होओगे) । ‘राम कबहुँ प्रिय लागिहो।' विन० २६६.१
लागीं : लगीं। (१) आरम्भ कर चलीं। 'जाइ बिपिन लागी तप करना ।' मा० १.७४.१ (२) प्रतीत हुई, जान पड़ी। 'उपमा सकल मोहि लघु लागी।' मा० १.२४७.२ (३) संपृक्त हुईं। 'जुबती भवन झरोखन्हि लागीं।' मा० १.२२०.४
लागी : (१) लगी । संपृक्त हुई । 'काई विषय मुकुर मन लागी।' मा० १.११५.१ 'चरनन्हि लागी ।' मा० १.२११ छं० १ (२) प्रतीत हुई । 'दूत बचन रचना प्रिय लागी।' मा० १.२९३.६ (३) आरम्भ हुई। 'लागी जरन बरात ।' मा० १.२६६ (४) तल्लीन । 'मातु काज लागी।' कृ० १० (५) लागि । लिये, हेतु । 'मनहुं रंक निधि लूटन लागी।' मा० १.२२०.२ ।।
लागु : (१) लाग+कए । लगा। 'जेहिं अनुराग लागु चित।' पा०म० ३३ (२) आ० - आज्ञा-मए । तू संलग्न हो। 'तो यहि मारग लागु ।' विन० २०३.१७
लागू : लाग+कए । सहारा । सोहत दिएँ निषादहि लागू ।' मा ० २.१६७.२
लागें : लगें । लगने से । 'कस न मरौं रघुपति सर लागें ।' मा० ३.२६.६
लागे : लगे । (१) लगे (आरम्भ किया)। 'राम नाम सिव सुमिरन लागे ।' मा० १.६०.३ (२) प्रतीत हुए । 'दंपति बचन परम प्रिय लागे ।' मा० १.१४६.७ (३) आबद्ध, संपृक्त, संलग्न । 'रोम रोम प्रति लागे कोटि कोटि ब्रह्मड ।' मा० १.२०१ (४) चुभ गये। बिषम बिसिख उर लागे।' मा० १.८७.३ (५) स्थित थे। 'लागे बिटप मनोहर नाना।' मा० १.२२७.४ (६) लागें । लगने से । 'दीन मलीन छीन तन डोलत मीन मजा सों लागे।' कृ० ३५
लागेउँ : आo ~~ भूकपु+उए । मैं लगा, आरम्भ किया। 'म न अनुमान करन तब लागेउँ ।' मा० ७.८४.३
_______________________________________________
953
लागेउ : भूक.पु०कए । लगा। (१) व्याप्त हुआ। 'लागेउ तोहि पिसाच जिमि ।' मा० २.३५ (२) आरम्भ किया । 'लागेउ बष्टि करै बहु बाना।' मा० ६.७३.२
लागेसि : आo-भूक ००+मए० । तू लगा, तूने उपक्रम किया। 'लागेसि अधम सिखावन मोही।' मा० ५.२४.३
लागै : लागई । (१) लगता है, प्रतीत होता है। 'समुझि महाभय लागे ।' विन० ११६.३ (२) लगे, प्रतीत हो । 'जौं पांचहि मत लागै नीका।' मा० २.५.३
लागैगी : आ० भ०स्त्री०प्रए । लगेगी प्रतीत होगी। 'लागैगी पै लाज।' कवि० ७.१७७
लागो : लाग्यो । उग आया । 'पिपीलिकनि पंख लागो ।' गी० ५.२४.३
लागौं : लागउँ । 'पा लागौं ।' कृ० ३५
लाग्यो, लागो : लागेउ । अनुरक्त हुआ । 'यों मन कबहूं तुमहिं न लाग्यो ।' विन० १७०.१
लाघवँ : लाघव से, हस्तकौशल से। 'अति लाघवं उठाइ धनु लीन्हा।' मा० १.२६१.५
लाघौ : सं०० (सं०) । लघुता-हल्कापन+शीघ्रता । कोशल ।
लाघो : लाघव । 'धावत दिखावत हैं लाघो राघौ बान के ।' कवि० ६.४८
लाज : सं०स्त्री० [सं० लज्जा)। (१) ब्रीडा। मा० १.२५६.१ (२) संकोच ।  'सो धौं को जो नाम लाज तें नहिं राख्यो रघुबीर ।' विन० १४४.१
लाजत : (१) वकृ०० (सं० लज्जमान>प्रा० लज्जंत)। लज्जित होता-होते । (२) (सं० लज्जयत् >प्रा० लज्जत) । लज्जित करता-करते । 'आछे मुनि बेष धरें लाजत अनंग हैं।' कवि० २.१५
लाजवंत : वि०० (सं० लज्जावत् >प्रा. लज्जवंत)। लज्जाल, संकोची । 'लाजवंत तव सहज सुभाऊ ।' मा० ६.२६.६
लाजहिं, लाजहीं : आ० प्रब० (सं० लज्जन्ते>प्रा० लज्जति>अ० लज्जहिं)। लजाते. ती हैं । मा० १.१४६; १.३२२ छ०
लाजा : (१) लाज । 'कहत सों मोहि लागत भय लाजा।' मा० १.४५.८ (२) सं०० (सं० लाज) । लावा, खील । 'अच्छत अंकुर लोचन लाजा ।' मा० १.३४६.५
लाजे : (१) भूक०० । लज्जित हुए। जिन्हहि देखि दिसि कुंजर लाजे ।' मा० १.३३३.७ (२) आ० प्रए० (सं० लज्जेत) । लज्जित हो जाय । 'गति बिलोकि खग नायकु लाजे ।' मा०.१.३१६.७
लाजंै : लाजहिं । लजाते हैं । "छबि बिलोकि लाजै अमित अनंग।' गी० ३.४.३
954
_______________________________________________
लाजै : आ.प्रए० (सं० लज्जते>प्रा० लज्जइ)। लजाता-ती है। 'कच निरखि ___ मधुप अवली लाजे ।' विन० ६३.७
लाटी : संस्त्री० (सं० लाट=जीर्ण वस्त्रखण्ड)। पपड़ी, भासी (लार सूखने से पड़ी हुई मलीन वस्त्राकार) छाल । 'सूखहिं अधर लागि मुहँ लाटी ।' मा० २.१४५.४
लाड़िले : वि०० (सं० लाडवत् >प्रा० लाडिल्ल)। दुलारे । 'सोइये लाल लाडिले रघुराई ।' गी० १.१६.१
लाडू : सं०० (सं० लड्डुक>प्रा. लड्डुअ) । लड्डू, मोदक । 'ठग के से लाडू खाए प्रेम मद छाके हैं ।' गी० १.६४.२
लात : सं०स्त्री० (सं० लत्ता) । पादप्रहार । 'हुमगि लात तक कूबर मारा।' मा० २.१६३.४
लातन्ह, लातन्हि : लात+संब० । लातों। ‘मुठिकन्ह लातन्ह दाँतन्ह काटहिं ।' मा० ६.५३.५, ६.७६.३
लाता : लात । मा० ६.४३.७
लाधे : लहे (सं० लब्ध>प्रा० लद्ध) । पाये । 'काहुं न इन्ह समान फल लाधे ।' मा० १.३१०.२
लाभ : सं०० (सं.)। प्राप्ति । (१) (हानि का विलोम) सिद्धि, पूर्ति । 'परहित.. हानि लाभ जिन्ह केरें।' मा० १.४.२ (२) मूलधन आदि पर मिलने वाला ब्याज आदि; धन आदि की प्राप्ति । 'जिमि प्रति लाभ लोभ अधिकाई ।' मा०. ६.१०२.२ (३) आवश्यक वस्तु की प्राप्ति । 'जथा लाभ संतोष सदाई ।' मा० ७.४६.२ (४) उन्नति, ऋद्धि । 'कहा, लाभ आगें सुत तोही ।' मा० ७.४८.७. (५) जागतिक आमोद-प्रमोद । 'लाभ कि रघुपति भगति अकुंठा ।' मा० ६.२६.८ (६) उपलब्धि, साध्य की सिद्धि, फल प्राप्ति । 'इहइ लाभ संकर जाना ।' मा० १.२११ छं. ३
लाभु : लाभ-+कए० । अद्वितीय लाभ । 'काहि यहु लाभु न भावा ।' मा० १.२५२.१
लामी : लांबी । लम्बी । 'तुलसी की बांह पर लामी लूम फेरिये ।' हनु० ३४
लाय : लाइ । लगाकर । गी० १.१४.२
लायउ : भूकृ०पू०कए० । लगाया, संश्लिष्ट किया । 'राम उठाइ अनुज उर लायउ ।' मा० ६.६१.२
लायक : वि० (फा० लायक)+ (सं० लायक =लाने वाला, प्राप्त करने वाला) । योग्य, सुपात्र । मा० १.१८.६
लाये : लाएं। (१) सहारा देकर । सिख वति चलन अगरियाँ लाये।' गी० १.३२.११ (२) लगाने से । 'मिलहिं न राम कपट लो लाये ।' विन० १२६.५
_______________________________________________
955
लायो : लायक । (१) लगाया। 'दसरथ भेद भगति मन लायो।' मा० ६.११२.६ (२) रोपा, स्थापित । 'लायो तरु तुलसी तिहारो।' हनु० ३७ (३) ले आया। 'जानत अनजानत हरि लायो ।' गी० ६.२.३
लाल, लाला : (१) सं०० (सं० लाल्य>प्रा० लल्ल)। दुलारा बालक । 'नंदलाल बिन जीज।' कृ० ४५ (२) वि० । अरुण । 'लाल कमल ।' जा०म० ६४
लालच : सं० । ललक, लोभ, लिप्सा, लालसा, तृष्णा । कवि० ७.१०६
लालचिन : लालची+संब० । लालचियों, लोभियों (को) । 'रतिन के लालचिन प्रापति मनक की ' कवि०७.२०
लालची : वि०० (सं० लालसित) । लालसायुक्त, लोभी। मा० १.४८ ख
लालचु : लालच+कए । एकमात्र लालसा । 'पितु दरसन लालच मन माहीं ।' मा० १.३०७.५
लालत : वकृ.पु० (सं० लालयत्>प्रा० लालंत) । दुलराता-ते; प्यार से सहलाता ते । 'लाल कमल जनु लालत बाल मनोजनि ।' जा०म० ६४
लालति : वक०स्त्री० । दुलराती । गी० १.१०.२
लालन : (१) ललन । 'पोढ़िए लालन पालने हौं झुलावौं ।' गी० १.१८.१ (२) सं०० (सं०) । सार-संभाल, दुलार, लाड़। 'लालन जोगु लखन ।' मा०. २.२००.१
लालसाँ : लालसा में, से । 'एहि लालसा मगन सब लोगू ।' मा० १.२४६.६
लालसा : सं०स्त्री० (सं०) । लिप्सा, तीव्र इच्छा, स्पहा । मा० १.१०४.२
लालहिं, लालहीं : भा०प्रब० (सं० लालयन्ति>प्रा० लालंति>अ० लालहिं) । दुलारते हैं । 'पितु मातु प्रिय परिवार हरहिं निरखि पालहिं लाल हीं।' पा०म०ई० १
लालहु : आ०मब० (अ०) । लालन करो, दुलारो। 'सुत ललाम लाल हु ललित।' रा०प्र० ४.४.३
लाला : लाल । अरुणवर्ण । 'नील सघन पल्लव, फल लाला' मा० २.२३७.४
लालि : पू० (सं० लालयित्वा प्रा० लालिय>अ० लालि) । दुलार करके । __सारसँभाल करके । 'कोटिक उपाय करि लालि पालिअत देइ ।' कवि० ७.११६
लालित : भूक०वि० (सं.)। दुलार किया हुआ-किये हुए। मा० ७ श्लोक २ 'लच्छि-लालित ललित करतल ।' विन० २१८.२
लाली : भूक स्त्री० । दुल रायी, सार-संभाल के साथ पाली । 'कलपबेलि जिमि ___ बहु बिधि लाली ।' मा० २.५६.३
लालु : लाल+कए । प्रिय पुत्र । 'बहुरि बच्छु कहि लालु कहि ।' मा० २.६८
लाले : भूक पुब० । सं० लालित>प्रा० लालिय) । दुल राये । 'जे सुक सारिका पाले, मातु ज्यों ललकि लाले ।' गी० ३.६.३
लावउँ : मा० उए० । लगाऊँ । 'कहहु सो करत न लावउँ बारा।' मा० १.२०७८
956
_______________________________________________
लावक : सं०पू० (सं०) । बटेर पक्षी । मा० ३.३८.७
लावत : वकृ०पु० । लगाता-ते । 'चाहि चुचुकारि चूमि लालत लावत उर ।' गी० १.११.२
लावति : वकृ०स्त्री० । लगाती । 'याहि कहा मैया मुह लावति ।' कृ० १२
लावतीं : वकृ०स्त्री० ब० । लगाती । 'पलको न लावती ।' कवि० १.१३
लावण्य : दे० लाबन्य । विन० १०.१
लावनिता : सं०स्त्री० (सं० लावण्यिता)। सौन्दर्यमयता। 'तुलसी तेहि औसर लावनिता ।' कवि० १.७
लावन्य : सं०० (सं० लावण्य) । सुन्दर अङ्गों में झलकने वाली भाभा, अङ्ग संघटना की चमक । मा० १.१०६
लावहिं : आ०प्रब० । (१) लाते हैं, उपस्थापित करते हैं। 'बहु बिधि लावहिं निज निज सेवा ।' मा० १.१६१.८ (२) लगाते हैं। 'एकटक रहे निमेष न लावहिं ।' मा० ७.३३.४
लावहि : आ०मए० । तू लगा, अनुरक्त कर । 'सरस चरित चित लावहि ।' विन० २३७.५
लावहु : आ०मब० । लगाओ, लावो (मन में समझो) । 'भाइहु लावहु धोख जनि ।' मा० २.१६१
लावा : (१) लावक (प्रा० लावअ) । बटेर । 'जनु सचान बन झपटेउ लावा ।' मा० २.२६.५ (२) सं०पु० (सं० लाज, लाजक>प्रा. लाऊअ) । धान के खील (जो विवाह की लाजाहुति में उपयुक्त होते हैं) । 'लावा होम विधान ।' पा०म० १३१ (३) भूकृ०० । लगाया। 'तुम्ह तो कालु हाँक जन लावा ।' मा० १.२७५.१
लावै : लावहिं । पहुंचाते-ती हैं । 'बामहि बाम सबै सुखसंपति लावै ।' कवि० ७.२
लावौं : लावउँ । (१) लगाऊँ । 'चरन चितु लावौं।' गी० १.१८.३ (२) (पहुंचाता हूं) लगाता हूं । 'जानत हौं हरि रूप चराचर, मैं हठि नयन न लावौं ।' विन. १४२.२ (३) ले आऊँ । 'अमृत कुंड महि लावौं ।' गी० ६.८.२
लावौंगी : आ०भ० स्त्री०उए० । लगाऊँगी । 'हरषि हिय लावौंगी।' २.५५.३
लासा : सं०० (सं० लसिका-स्त्री०) । गोंद आदि से बना हुआ सरेस जिससे चिपकाकर पक्षियों को फांसा जाता है । 'नाम लगि लाइ, लासा ललित बचन कहि, ब्याध ज्यों, बिषय बिहानि बझावौं ।' विन० २०८.२
लाह : (१) लाभ (प्रा.)। 'लोयन लाह लूटति नागरी ।' जा०म० छं० १६ (२) सं०स्त्री० । आग की लौ। (३) लता आदि की पतली शाखा। ‘जा की आँच अजहं लसति लंक लाह सी।' कवि० ६.४३
_______________________________________________
957
लाहु : लाभु (अ०) । मा० १.२०.२ 'हानि कुसंग सुसंगति लाहू।' मा० १.७.८
लिग : सं०० (सं.)। शिवलिङ्ग (शिवमूर्ति-विशेष)। मा० ६.२६
लिंगमई, लिंगमयी : (दे० मई) शिवलिङ्गों से व्याप्त (काशी) । कवि० ७.१८२
लिएँ : लिए हुए, ग्रहण किये हुए (मुद्रा में) । 'मंगल द्रब्य लिएं सब ठाढी ।' मा० १.२८८.६
लिए : (१) भूकृ००ब० । ले लिये, प्राप्त किये, ग्रहण किये। लिए गोद करि मोद समेता ।' मा० १.३५४.३ (२) लेकर। ‘लिए फल मूल भेंट · मिलन चलेउ ।' मा० २ ८८.२ (३) परसर्ग । तदर्थ । दे० लिये।
लिखत : वकृ०० । लिखता-लिखते । लिखत सुधाकर गा लिखि राहू ।' माल २.५५.२
लिखन : भकृ० अव्यय । लिखने, रेखा खींचने । 'महि न लिखन लगीं सब सोचन।' मा० २.२८१६
लिखा : भूक०पु० । लिपिबद्ध किया। मा० १.६८ (२) रेखित किया। लिखा बिरंचि जरठ मति भोरें।' मा० ६.२६.३
लिखाइ : प्रकृ० । लिखा कर, लिपिबद्ध करा कर । 'चले. 'लगन लिखाइ के।" पा०म०छं० १०
लिखाउ : आ०-आज्ञा-मए० । तू लिखा ले । रिनिया हौं, धनिकतं पत्र लिखाउ ।' विन १००.७
लिखाए : भूक.पुं०ब० । लिपिबद्ध कराये । गी० १.६.३
लिखि : पूकृ० । (१) लिखकर । 'सत्य कहउँ लिखि कागद कोरें।' मा० १.६.११ (२) चित्रित कर, उरेह कर । 'जहँ तह मन हुं चित्र लिखि काढ़े।' मा० २.८४.१
लिखिअ : आ० कवा०प्रए० । लिखिए, लिखा जाय, लिखा जाता है। लिखिअ पुरान ।' मा० १.७.११
लिखित : भूकृ०वि० (सं०) । (१) लिपिबद्ध । (२) चित्रित । 'चित्र-लिखित ।' मा० ६.८६ छं०
लिखी : भूक स्त्री० । (१) लिपिबद्ध की, रेखित की । लिखी न भलाई भाल ।' कवि० ७.१६५ (२) कविता रचकर लिपिबद्ध की । 'हिये हेरि तुलसी लिखी।' विन० २७७.३
लिखे : लिखित (प्रा. लिखिय) ब० । (१) लिपिबद्ध । बिधि के लिखे अंक ।' मा० ६.२६१ (२) आलिखित, चित्रित । चित्र लिखे जन जहँ तह ठाढ़े।' मा० २.१३५६ (३) लिखने पर, से । 'चित्र कल पतरु कामधेनु गह लिखे न बिपति नसावै।' विन० १२३.३
लिखै : आप्रब । लिखते हैं, चित्रित करते हैं । 'सिय अंग लिखें धातु राग । गी०. २.४४.४
958

लख्यो : भूकृ००कए० । लिखा । कवि० ७.५६
लिपि : सं० स्त्री० (सं.) । लेख, अङक । 'तेरे हेरें लोपै लिपि बिधिहू गनक की।' कवि०७.२०
लिय : भृकृ० । लिया, ग्रहण किया, चना । 'रामचरित सत कोटि महँ लिय महेस जियँ जानि ।' मा० १.२५
लिय उ : लिय+कए । 'पुनि प्रभु बोलि लियउ हनुमाना । मा० ६.१०७.१
लिया : लिय । ग्रहण किया। 'तेरो नाम लिया रे।' विन०.३३.४
लिये : लिए । कृ० १७ (२) लेने । 'नाम लिये तें।' कवि० ७.१२६ (३) ले लेने पर । 'मनि लिये फनि जिय ब्याकुल बिहाल रे ।' विन० ६७.३ (४) परसर्ग । के हेत, तदर्थ । 'तेरे लिये जनम अनेक मैं फिरत न पायो पार ।' विन १८८.३
लियो : लियउ । (१) ग्रहण किया। लियो काढि बामदेव नाम घृतु है।' विन० २५४.२ (२) अङ्गीकृत किया । 'कृपानिधान मोहि कर गहि लियो।' मा० ७.५ छं० २
लिलार : ललाट (प्रा० निडाल) । (१) मस्तक । मा० ५.३८.६ (२) भाग्य । 'जो बिधि लिखा लिलार ।' मा० १.६८
लिवाइ : लवाइ । लिवाकर, साथ लेकर । 'रामहि चले लिवाइ।' जा०म० ३६
लिहे : लिए । लिये हुए। रा०न० ६
ली : लई । पाई, ले ली । 'मैं सबै के जी की थाह ली।' कवि० ७.२३
लीक, लीका : सं-स्त्री० (सं० लेखा-रेखा)। (१) लकीर । 'मानों प्रतच्छ परब्बत की नभ लीक लसी कपि यो धुकि धायो।' कवि० ६.५४ (२) स्थान, संख्या । 'भटमहं प्रथम लीक जग जामू ।' मा० १.१८०.७ (३) मर्यादा, सीमा। 'अजहं गाव श्रुति जिन्ह के लीका ।' मा० १.१४२.२ (रेखा अर्थ सर्वत्र अनुस्यूत है।)
लीख : लीक । 'बे द बिदित यह लीख ।' विन० १८.४
लीचर : सं०० । अशक्ति, शिथिलता (2)। 'बाहुक सुबाहु नीच लीचर मरीच ।' हनु० ३६ अवधी में 'लीचर' नवजात पशु-शिशु को कहते हैं जो निश्चल' से लगता है।
लीजत : वकृ०पुकवा० । लिया जाता है, लिये जाते। 'लीजत क्यों न लपेटि  लवा से ।' हनु० १८
लीजिए : आ०-कवा-प्रए । लिया जाय । मा० ४.१० छं०
लीजै : लीजिए । 'दै पठयो पहिलो बिढ़तो ब्रज सादर सिर धरि लीजै ।' कृ० ४६ .
लीन : भूकृ०० (सं.)। (१) मग्न, डूबा हआ। (२) तदाकारता प्राप्त। ता तें मनि हरि-लीन न भयऊ ।' मा० ३.६.२ (३) ध्यानावस्थ, समाहित, एकान । 'राम भगति रस लीन ।' मा० १.२२ (४) लीन्ह । लिया। ‘सींक धनुष हित सिखन सकुचि प्रभु लीन ।' बर० ८
लीनी : (१) लीन+स्त्री० (सं० लीना)। मग्न । 'कपटी मुनि पद रह मति लानी। मा० १.१७२.७ (२) लीन्ही । ली। 'सपनखा आगें करि लीनी।' मा० ३.१८.६
लीन्ह, लीन्हा : भूक०० । लिया । मा० १.४८.७, ९८.८
लोन्हि : लीन्ही । 'लीन्हि परीछा कवन बिधि ।' मा० १.५५
लोन्हिसि : आ०-भूक०स्त्री०+प्रए । उसने ली। 'लीन्हिसि रथ बैठाइ ।' मा० ३.२८
लोन्हीं : लीन्ही+ब० । लीं। 'बहुरि बोलाइ सुआसिनि लीन्हीं।' मा० १.३५३.५
लीन्ही : भूकृ०स्त्री० । ली। मा० १.२३५.३
लीन्हें : लिये हुए, लेकर । 'प्रगटे अगिनि चरू कर लीन्हें ।' मा० १.१८६.६
लीन्हे : (१) भूक०० ब० । लिये । 'बोलि सकल सुर सादर लीन्हे ।' मा० १.१००.१ (२) लीन्हें । लिये हुए। 'काम कुसुम धनु सायक लीन्हे ।' मा० १.२५७.१
लीन्हेउ : लीन्हा+कए । लिया। बिषय मोर हरि लीन्हेउ ग्याना ।' मा० ४.१६.३
लीन्हेसि : आ०-- भूक.पु०+प्रए० । उसने लिया। 'हरि लीन्हेसि सरबसु अरु नारी ।' मा० ४.६.११
लीन्हो : लीन्ह्यो। 'लीन्हो उखारि पहारु बिसाल ।' कवि० ६.५४
लीन्ह्यो : लीन्हेउ । पाया, लिया । 'बिमुख हबालि फल कौन लीन्ह्यो।' कवि०
लीबी : भकृ०स्त्री० । लेनी (चाहिए) । 'जानि लीबी गति ।' गी० १.६६.५
लीयो : लियो । 'कुमारग कोटिक के धन लीयो।' कवि० ७.१७६
लीलहिं : लीला में खेल-खेल में । 'लीलहिं नाघउँ जलनिधि खारा।' मा० ४.३०.८
लीलहि : लीला को। मा० ७.१२८.३
लीलाँ : लीला से, खिलवाड़ में । 'लीला हत्यो कबंध ।' मा० ६.३६
लीला : सं०स्त्री० (सं.)। (१) क्रीडा, खेल । 'हर गिरि जान जासु भुज लीला ।' मा० ६.२५.१ (२) नाटय, अभिनय, वेषान्तर ग्रहणपूर्वक स्वाँग । 'सर्वदरसी जानहिं हरि लीला ।' मा० १.३०.६ (३) ईश्वर की परमा शक्ति; जगत्प्रसार करने वाली योगमाया। 'लीला सगुन जे कहहिं बखानी।' मा० १.३६.५ (४) ईश्वरावतार का नरचरित्र । 'राज बैठि कीन्हीं बहु लीला।' मा०  १.११०.८ (५) अभिनय, लीला-नाट्य । करउँ सकल रघुनायक लीला ।' मा० ७.११०.४ (६) लील रस की अनुभूति । 'सोउ जाने कर फल यह लीला।" मा० ७.२२.५
लीलातनु : यों तो सम्पूर्ण सष्टि ब्रह्म की लीला है उसी का रूपावतरण है, परन्तु इस लीला का कोई वाह्य प्रयोजन नहीं-लीलाया एव प्रयोजनत्वात्-परन्तु जब ब्रह्म धर्म के उद्धार हेतु विशेष रूप ग्रहण करता है तब वह सप्रयोजन अवतार होता है और उस अवतारी रूप को 'लीलातनु' कहा जाता है । 'भगत हेतु लीला-तनु गहई।' मा० १.१४४.७ वही रूप भक्तों का उपास्य भी होता है।
लीलारस : बल्लभाचार्य ने 'भक्तिरस' को 'लीलारस' नाम दिया है। शान्त भक्त भगवान के स्वरूप का साक्षात्कार करते हैं (लीला का नहीं) जबकि दास, सखा, वत्सल तथा मधुर भक्त लीलाओं का आनन्द लेते हैं- यही लीलारस है। इनमें दासभक्त लीला-सहयोगी न होकर द्रष्टा मात्र रहते हैं जबकि शेष लीला सहयोगी रहते हैं । 'बालकेलि लीला-रस ब्रज जन हितकारी ।' कृ. १
लीलावतार : परमेश्वर का सष्टि रूप में अवतरण लीलावतार से भिन्न है। उपासना हेतु मुख्यतः पांच रूप माने गरे हैं - (१) अर्चावतार=मति आदि में देवता की प्राणप्रतिष्ठा (२) ब्यूहावतार वासुदेव, सकर्षण, 'धुम्न और अनिरुद्ध का चतुव्यूह; अथवा राम, लक्ष्मण, भरत और शत्रुघ्न का चयं ह । (३) विभवावतार भगवान के विविध अवतार (दस या चौबीस या अन्य अंशावतार)। (४) सूक्ष्म == उक्त सभी में अनुस्यूत परमात्मा । (५) प्रत्यक् = अन्तर्यामी == तुरीय। इनमें व्यूह और विभव को 'लीलावतार' भी कहते हैं । कभी-कभी सम्पूर्ण सष्टि को लीलावतार कहा जाता है--दे० लीला तनु-परन्तु भू-भार हरण हेतु अवतार को विशेषत: 'लीलावतार' कहा जाता है।
लीलावतारी : वि.पु. (सं० लीलावतारिन् ) । लीलावतार लेने वाला, लीलातनु ग्रहण करने वाला । विन० ३८.१; ४३.१ ।।
लीलि : पूकृ० (सं० निगीर्य>प्रा० निइलिअ>अ० नीलि) । निगल (कर) । तिन की मतिः . लोभ लालची लीलि लई है। विन० १३६.२
लीलिबे : भकृ०० । निगलने । 'लंक लीलिबे को काल रसना पसारी है।' कवि० ५५
लीले : भूक०० ब० । निगल लिये । सिंह के सिसु मेंढक लीले ।' विन० ३२.२
लुकाइ, लुकाई : पूकृ० । छिपकर । मा० ६.२३ क । 'प्रभु देखें तरु ओट लुकाई ।' मा० ३.१०.१३
_______________________________________________
961
लुकात : वकृ०पू० । छिपता-छिपते। 'लवा ज्यों लुकात तुलसी झपेटें बाज के ।' कवि० ६६ .
लुकाने : भूक.पु.ब ० । छिप रहे । 'कपटी भूप उलूक लुकाने ।' मा० १.२५५.२
लुके : लुकाने । 'लुके उलूक नरेस ।' रा०प्र० १.५.५
लुगाई : लोगाई। मा० १.२०४.८
लुटाई : भक०स्त्री० । लुटा दी, बिखेर दी। निज संपदा लुटाई ।' गी० १.१.५
लुटि : लूटि । 'नयन लाभ लटि पाई।' गी० १.५५.८
लुटैया : वि०ब० । लूटने वाले। 'ह्र हैं सकल सुकत सुख भाजन लोचन-लाहु लुटेवा।' गी० १.६.५
लुठत : वकृ.पु. (सं० लठत्) । लोटता हुआ, बिखरता हुआ। 'जनु महि लुठत सनेह समेटा।' मा० २.२४३.६
लुनाई : लोनाई । सुषमा । गी० १.५२.४
लुनिअ : आ०कवा०प्रए० (सं० लूयते>प्रा० लुणीअइ) । काटा जाता है। 'बवा सो लुनिभ ।' मा० २.१६.५
लुनिअत : वकृ.पुंकवा० (सं० लूयमान>प्रा० लुणीअंत)। काटा जा रहा है । ___'बयो लुनिअत सब याही दाढ़ीजार को।' कवि० ५.१२
लुनिए : लुनिअ । काटा जाय । 'बयो सो सब लुनिए।' कृ० ३७
लुनिहै : आ०म०प्रए० (सं० लविष्यति>प्रा० लुणिहिइ) । काटेगा। 'लुनिहै पै सोई सोई जोई जेहिं बई है।' गी० १.८६.६
लुप्त : भूक०वि० (सं.) । अदृश्य, नष्ट । 'लप्त भए सदग्रंय ।' मा० ७.६७
लुबुध : लुब्ध । 'लुबध मधुप इव तजइ न पासू ।' मा० १.१६.४
लुब्ध : भूकृ०वि० (सं०) । लोभग्रस्त, लिप्सा-लीन । विन० २०७.३
लुभाइ, लुभाई : पूकृ० । लुब्ध होकर, लोभलीन हो। 'जहँ बसंत रितु रही लुभाई।' मा० १.२२७.३ रही है लुभाइ लुभाई ।' गी० १.५५.२
लुभाने : भूक.पुब०। लुब्ध हुए। 'मुक्ति निरादर भगति लुभाने ।' मा० ७.११६.७
लुभाहिं : आ०प्रब० । लुब्ध होते हैं । 'बिरत जे परम सुगतिहुँ लुभाहिं न ।' विन० २०७.३
लूक : सं०पु० (सं० उल्का-स्त्री.) । टूटा हुआ तारा । 'दिनहीं लूक परन बिधि लागे।' मा० ६.३२.७
लूगा : सं०पू० । लुगड़ा, चिथड़ा, जीर्ण वस्त्र-खण्ड । विन० ७६.१
लूटक : वि.पु. (सं० लुण्टाक)। लूटने वाला, अपहरण करने वाला । 'मुनिपट लूटक पटनि के।' कवि० २.१६ (पट्ट-रेशम की शोभा हरने वाले मुनिपट)। ट
962
_______________________________________________

लूटत : वकृ.पु । छीनता-ते, अपहरण करते । 'प्रभु तिय लूटत नीच भर ।' दो. ४४०
लूटति : वकृ०स्त्री० । लूटती-तीं । 'लोयन लाह लूटति नागरौं ।' जा०म०छं० १९
लूटन : भकृ० अध्यय । लूटने । 'चले रंक जन लूटन सोना ।' मा० २.१३५.२
लूटहिं : आ०प्रब० । लूटे ले रहे हैं । 'लूटहिं तसकर तव धामा ।' विन० १२५.८
लूटि : कृ० । लटकर । 'जस रासि.. 'लटि लई है।' कवि० ७.१७५
लूटिबे : भकृ०पु । लूटने । 'रंक लूटिबे को मानो मनि गन ढेरै ।' गी० ५.२७.३
लूटिहैं : आ०भ०प्रब० । लूटेंगे। 'लोग लूटिहैं लोचन लाभ अघाइ के।' गी. १.७०.१
लूटीं : लूटी+ब० । 'रंकन्ह राय रासि जनु लूटी।' मा० २.११७.८
लूटी : भूक०स्त्री० । लूट ली, अपहृत की । 'तिहुं तिभुवन सोभा मनहुं लूटी ।' गी० २.२१.२
लूट् यो : भूकृपु०कए ! लूट लिया। कवि० ६.४६
लूम : सं०पु+स्त्री० (सं०) । पूछ । हनु० ३४; दो० ३४५
लूरति : वकृ.स्त्री० (सं० लोलन्ती)। चञ्चल हो रही, झूल रही। 'उरसि रुचिर बनमाल लूरति ।' गी० ५.४७.२
लूलो : वि०कए. (सं० लूनः कटे अङ्ग वाला) । हस्तविहीन । 'रहौं दरबार परो लटि लूलो।' हनु० ३६
ले : लेहि (तू प्राप्त कर)। 'साँसति तुलसीदास की सुनि सुजस तुही ले ।' विन० ३२.५
ले, लेइ : (१) आप्रए० (सं० लाति>प्रा० लेइ)। लेता-ती है। 'उतरु देई न, लेइ उसासू ।' मा० २.१३.६ (२) ले, ले लेवे । 'छोनि लेइ जनि ।' मा० १.१२५
लेइ : प्रकृ० । लेकर । 'मैं बन जाउं तुम्हहि लेइ साथा ।' मा० २.७१.३
लेइअ : आकवा०प्रए । लीजिए। लेइअ संग मोहि छाडिअ जनि ।' मा० २.६६.७
लेइहि : आ०भ०प्रए० (सं० लास्यति>प्रा० लेइहिइ) । लेगा, लेगी। 'जानेह लेइहि मागि चबेना।' मा० २.३०.६
लेई : लेइ । लेता है । 'चारा चाषु बाम दिसि लेई ।' मा० १.३०३.२
लेउँ, लेऊँ : आ० उए० (सं० लामि>प्रा. लेमि>अ० लेउँ) । लू, प्राप्त करू । 'जिमि गर्व तकइ लेउ केहि भांती ।' मा० २.१३.४; २.१६०.२
लेउ : आ०-अनुज्ञा-प्रए० (सं० लातु>प्रा० लेउ) । ले, ले सकता है। 'जानि लेउ जो जाननिहारा ।' मा० २.१३७.१
_______________________________________________
963
लेख, लेखइ, ई : आ०ए० (सं० लेखति) । लेखे में लेता है, गिनता है, समझता है। 'तुलसी नपति भवतब्यता बस काम कोलक लेखई।' मा० २.२५ छं०
लेखउँ : आ० उए । लेखे में ल', गिन मान । 'केहि खगेस रघुपति सम लेखउँ।' मा० ७.१२४.४
लेखति : वकृ० स्त्री० । रेखाएँ (लेखाएँ) बनाती। 'चारु चरन नख लेखति धरनी।' मा० २.५८.५
लेखन : भकृ० अव्यय । आलेखित करने, चित्रित करने, रेखाडि कत करने । 'सो समाज चित चित्रसार लागी लेखन ।' गी० १.७५.२
लेखनी : सं०स्त्री० (सं.)। लेखोपकरण = कलम । वैरा० ३५
लेखहिं : आ.प्रब० । मानते हैं, गिनते हैं । मा० २.१३४.८
लेखहि : भा.मए । गिन, समझ । 'सब सम लेखहि बिपति बिहाई ।' विन १२६.३
लेखहीं : लेखहिं । 'सुफल जीवन लेखहीं।' मा० १.३१६ छं०
लेखहु, लेखहू : आ०मब० । गिनो, समझो। 'रघुबरहि कुंभज लेखहू ।' जा०म०छं० १२
लेखा : (क) सं०० (सं.)। (१) लेख । (२) देवता । 'भए अलेख सोच बस लेखा।' मा० २.२६४.८ (३) चित्र । 'लोचन मोर पंख कर लेखा।' मा० १.११३.३ (४) समानता । 'गुर सिष अंध बधिर कर लेखा।' मा० ७.६६.६ (५) (सं० लेख्य) । अङ्क, आंकड़ा, गणना । 'सो मुख जो करन चह लेखा।' मा० ४.२२.१ (ख) भूक० । गिना, माना । 'आदरु कीन्ह पिता सम लेखा।' मा० २.२६४.८ (ग) लेखइ। समझता है । 'अचल मोहबस आपुहि लेखा।' मा० ७.७३.५
लेखि : (१) पूकृ० । गिनकर, समझकर। (२) आ०-आज्ञा-मए । तू समझ।  __'सुमिरि सत्य सब लेखि ।' रा०प्र० २.४.३
लेखिन : आ०कवा०प्रए । लेखे में लाइए, समझिए । 'भूप सुसेबित बस नहिं लेखिअ ।' मा० ३.३७.८
लेखिये : लेखिअ । 'देहवंत न लेखिये ।' विन० १३६.११
लेखी : लेखि । मानकर । 'मुदित सफल जग जीवन लेखी।' मा० १.३४६.४
लेखु : आo-आज्ञा-मए० । (१) तू गणना कर । 'अंक लिखि लखू ।' दो० ३६ (२) तू समझ । 'सफल जीवन लेख । गी० ७.६.२
लेखें : लेखे में, गणना में । 'भयउँ भाग भाजन जन लेखें ।' मा० २.८८.५
लेखे : (१) भूक पुब । गिने, समझे। 'ते पुनि पुन्य पुज हम लेखे ।' मा० २.१२०.८ (२) लेखा । गिनती। 'कहहु तूल केहि लेख माहीं।' मा० १.१२.११ (३) कारण । 'माधव अब न द्रवहु केहि लेखे।' (केहि लेखे =किस हेतु क्या समझकर ।)
964
_______________________________________________
लेखो : लेखा+कए० । गिनती। 'लेखो कोन हमारो ।' गी० २.६७.३
लेखौं : लेखउँ । 'तब निज जन्म सफल करि लेखौं ।' मा० ७.११०.१४
लेखौ : लेख ह । समझो। 'सफल जीवन लेखोरी।' गी० ७.७.६
लेत : (१) वकृ०० (सं० लात्>प्रा० लेत)। लेता-लेते । 'लेत चढावत बँचत्त गाढ़ें।' मा० १.२६१.७ (२) लेते ही तत्क्षण । 'नाम लेत भव सिंध सुखाहीं।" मा० १.२५.४
लेति : वकृ०स्त्री० । लेती। मा० १.१४७
लेतु : लेत+कए । लेता । 'जो.. राम नाम लेतु है ।' कवि० ७.८२
लेते : क्रियाति.पुब० । तो लेते । 'सुनि सादर आगे हर लेते।' विन० २४१.१
लेन : भकृ० अव्यय । लेने । 'चले लेन सादर अगवाना ।' मा० १.६५.२
लेना : (१) सं०पु० । ग्रहण करना, पाना । 'झूठइ लेना झूठा देना।' मा० ७.३६.७ (२) लेन । लेने । 'लंका रहइ को पठई लेना।' मा० ६.५५.७
लेनो : लेना+कए० । 'मोको न लेनो न देनो कछ।' कवि० ७.१०२
लेब, लेबा : भक.पु । लेना (होगा)। 'लेब भली बिधि लोचन लाहू ।' मा० १.३१०.६ 'सो प्रसादु मैं सिर धरि लेबा ।' मा० २.१०२.८
लेरुआ : सं० । गाय आदि का नवजात शिशु । बछड़ा। 'ललन लोने लेरुआ, बलि मैया ।' गी० १.२०.१
लेवाइ, लेवाई : लवाइ । साथ लेकर । 'रघुकुल-दीपहि चले लेवाई।' मा० २.३६७
लेवादेई : सं०स्त्री० । लेन-देन ; उदला-बदल । 'स्वारथ के साथी मेरे हाथी स्वान लेवादेई ।' विन० ७५.२
लेवैया : वि.पु.। लेने वाला । 'भुजा गहि काढ़ि लेवैया ।' कवि० ७.५२
लेस : सं०० (सं० लेश) । क्षुद्र अंश, थोड़ा-सा । 'तुलसी तऊ लेस रिस नाहीं ।' वैरा० ४६ 'कतहुं नहीं अघलेस ।' मा० १.१५३
लेसा : लेस । मा० ३.२८.१० ।
लेसु : लेस+कए । एक कण । 'मोहि न सो दुख लेसु ।' मा० २.५५
लेसै : आ०प्रए० (सं० लेशयति-लिश गतो>प्रा० लेस इ) । दीप्त करे, जलाये । ___एहि विधि लेस दीप ।' मा० ७.११७
लेहउँ: आ०भ० उए० (सं० लास्यामि>प्रा. लेहिमि>अ० लेहिउँ)। लगा। __अंसन्ह सहित मनुज अवतारा लेहउँ।' मा० १.१८७२
लेहहिं : आ०भ० प्रब० । लेगे । 'रखि हहिं भवन कि लेहहिं साथा ।' मा० २.७०.५
लेहिं, लेहीं : (१) आप्रब० (अ.)। लेते-ती हैं। 'सो सुधारि हरिजन जिमि लेहीं।' मा० १.७.३ (२) धारण करते हैं, (कर सकते हैं)। 'डाबर कमठ किः मंदर लेहीं ।' मा० २.१३६.७
_______________________________________________
965

लेहि : आ०मए । तू ले, ग्रहण कर । 'कहेउ कृपाल लेहि उतराई।' मा० २.१०२.४
लेहु, लेहू : आ०मब० (अ०) । लो, प्राप्त करो। मा० २.३३.६; ५०४
लेहौं : लेहउँ । लगा-गी । 'बल या लेहौं।' कवि० २.३।
लै : (१) लइ । लेकर । 'बालक सब ल जीव पराने ।' मा० १.६५.५ (२) ले जाकर । 'तहां बासु ल दीन्ह भुआला ।' मा० १.२१६.७ (३) ग्रहण करके । 'पाय ले परहीं ।' मा० २.११.८
लैन : लेन । लेने। 'जन सोभा आये लैन।' गी० १.३५.२
लैबे : 'लेबा' का रूपान्तर । लेने । 'लैबे को एक न देबे को दोऊ ।' कवि० ७१०६
लेहैं : (१) लेहहिं । लेगे, प्राप्त करेंगे। 'लै हैं लोचन लाहु, सुफल लखि ललित मनोरथ बेली।' गी० १.८.४ (२) लाइहैं । लगाएंगे। “सहज कृपालु बिलंब न ले हैं।' गी० ५.५१.१
लेहै : (१) लेहै । लेगा। 'लोचन सुख लहै ।' गी० १.६६.२ (२) लाइहै ।  _लाएगा, लगाएगा।
लेहौं : (१) लेहौं । लूगा (लूगी)। 'भाई हौं कहा अवध रहि लहौं ।' गी. २.६५.१ (२) लाइहों। लगाऊँगा-गी। 'निरखि हरषि उर लंहों।' गी० १.६६.४
लोइ, लोई : लोक (प्रा. लोय) । लोग, जनता। 'ब्रह्मानंद मगन सब लोई ।' मा० १.१६४.२
लोक : सं०० (सं०) । (१) दृश्यमान जगत् । (२) तीन लोक = स्वर्ग, पृथ्वी और पाताल । (३) चौदह लोक-दे० भुवन । (४) यह जीवन । 'लोक लाहु परलोक निबाह ।' मा० १.२०.२ (५) व्यावहारिक जगत् । 'लोक बेद बर बिरिद बिराजे ।' मा० १.२५.२ (६) दो लोक=ऐहिक तथा आमुष्मिक जीवन । 'उभय लोक निज हाथ नसावहिं।' मा० ७.१००.७ (७) जनता, लोग। जैसे, लोकमत। 'भे सब लोक सोक बस बौरा ।' मा० २.२७१.१ (८) समाज । 'लोक लखि बोलिए।' कवि० १.१५ (९) लौकिक मर्यादा। 'लोक राखे निपट निकाई है।' गी० ५.२६.३ (१०) (सं० श्लोक) =सिलोक +लोक (मान्यता) । यश । 'सुत बित लोक ईषना तीनी ।' मा० ७.७१.६
लोकउ : लोक भी, व्यावहिक विश्व भी। 'पाइहि लोक उ बेदु बड़ाई ।' मा० २.२०७.२
लोकनाथ : लोकपाल (सं.)। कवि० ७.२५
लोकनि : लोक+संब० । लोकों (को) । 'लोकनि सिधारे लोकपाल सबै ।' कवि० ६.५८
लोकप, पति : लोकपाल (सं०) । मा० २.२.३, मा० १.३३३
966
_______________________________________________
लोकपति : लोकपाल । मा० १.३३३
लोकपाल : (१) सं० (सं.)। दिक्पाल (इन्द्र, अग्नि, यम, निऋत, वरुण, वाय, कुबेर और ईशान) । मा० १.३२६.६ (२) लोक-रक्षक (राजा आदि)।
लोकपालन : लोकपाल+संब०। लोकपालों (जनरक्षकों) । 'परम कृपाल जो नपाल लोकपालन पं ।' कवि० ६.२६
लोकमत : जनरुचि, प्रजा वर्ग का अभिप्राय । मा० २.२५८
लोकमान्यता : सं०स्त्री० (सं०) । विश्व प्रसिद्धि, लोक-सम्मान, कीर्ति । 'लोक मान्यता अनल सम कर तप कानन दाहु ।' मा० १.१६१
लोकरीति : लोक प्रचलन, जागतिक व्यवहार । कवि० ७.६४
लोकलाज : (दे० लाज)। लोकमर्यादा का संकोच; व्यवहार पालन का संकोच । गी० ४.२.२
लोका : लोक । मा० १.२७.१
लोकि : धकृ० । बीच में ही लपक लेकर, झपट लेकर, रोककर । तिलोचन सो बिष लोकि लियो है।' कवि० ७.१५७ ।
लोकु : लोक+कए । यह संसार, लोकाचार । 'लोकु बेदु बध-संमत दोऊ ।' मा.. २.२०७.१
लोके : (सं.)। लोक में । मा० ७.१०८.७
लोग : लोक (प्रा०) । जन, जनता । मा० १.६६.२
लोगनि, न्ह, न्हि : लोग+संब०। (१) लोगों। 'निज जड़ता लोगन्ह पर डारी ।' मा० १.२५८.७ (२) लोगों ने। 'भवन लोगन्ह रचे ।' मा० १.२६६. (३) लोगों से (को)। पूंछेउ मगु लोगन्हि मदु बानी ।' मा० २.११८.५
लोगाईं : लोगाई+ब.। स्त्रियां। 'बद बद मिली चली लोगाई।' मा. १.१९४३
लोगाई : लोग+स्त्री० । स्त्री लोग, स्त्री।
लोगु, लोगू : लोग+कए० (अ०) । जन-वर्ग । 'तो कृत कृत्य होइ सब लोग ।' मा०. १.२२२.७; २.८८.७
लोचन : सं०पू० (सं.)। (१) नेत्र। मा० १.३७ (२) वंश लोचन । (३) गोरोचन । 'अच्छत अंकुर लोचन लाजा ।' मा० १.३ ४६.५
लोचनन, लोचननि : लोचन+संब० । नेत्रों (में)। 'लोचननि चकाचौंधी चित्तनि खभार सो।' हनु० ४
लोचनामिराम : वि० (सं०) । नेत्र-सुखद। कवि० १.१२
लोचनाभिरामा : लोचनाभिराम। मा० ६.५६.६
लोचनि, लोचनी : (समासान्त में) वि०स्त्री० (सं०) । नेत्रों वाली । 'मगसावक लोचनि ।' मा० १.२६७.२
_______________________________________________
967
लोचहिं : आ०प्रब० । पर्यालोचन करते हैं; विचारते-खोजते हैं। 'बरु अनुदिन लोहिं ।' पा०म०६
लोटन : संपु० (सं० लुठन, लुण्ठन) । लड़खड़ाहट, स्खन, लेटना, लढ़कना । 'कांट कुराय लपेटन लोटन ठाँवहि ठाउँ बझाऊ रे ।' विन० १८६.४
लोथि : सं०स्त्री० । शव । मृतक शरीर ।
लोथिन : लोथि+संब० । लोथों, शवों। 'लोथिन सों लोहू के प्रबाह चले जहाँ तहाँ।' कवि० ६.४६
लोन : सं०० (सं० लवण>प्रा० लोण)। (१) नमक । मा० २.३०.८ 'बरी बरी को लोन ।' दो० ५४६ (२) लावण्य । (३) सुन्दर । 'करि सिंगार अति लोन तो बिहसति आई हो।' रान० १०
लोना : लोन । सुन्दर, कमनीय (दे० लावन्य) । 'साँवर कुवँर सखी सुठि लोना।' मा० १.२३३.८
लोनाई : लावनिता । लावण्य, सौन्दर्याभा । मा० १.२३७.१
लोनी : वि०स्त्री० । लावण्यवती। 'सोहैं साँवरे पथिक, पाछे ललना लोनी ।' गी. २.२२.१
लोनु : लोन+कए० । नमक, क्षार । 'मनहुं जरे पर लोनु लगावति ।' मा० २.१६१.१
लोने : वि.पु०ब० । लावण्ययुक्त, सुन्दर । 'लालन जोगु लखन लघु लोने ।' मा० २.२००.१
लोप : (१) सं०० (सं०) । अदर्शन । (२) वि० (सं० लुप्त>प्रा० लुप्प = लोप्प) । अदृश्य, लप्त । 'लोप प्रगट प्रभाय को।' हनु०३१
लोपति : वकृ.स्त्री० । लुप्त करती। 'लोपति बिलोकत कुलिपि भोंड़े भाल की।' कवि० ७.१८२
लोपित : भूक ०वि० (सं.)। लुप्त किया-किये । 'कोपित कलि लोपित मंगल मगु ।' विन० २४१
लोपिहैं : आ०भ०प्रब० । लुप्त (नष्ट) कर देंगे। मंडि मेदिनी को मंडलीक लीक लोपिहैं ।' कवि० ६.१
लोपी : भक०स्त्री० । लुप्त कर दी । 'कलि सकोप लोपी सुचाल ।' विन० १६५.२
लोपेउ : भूक०पु०कए । लुप्त कर दिया । लोपेउ काल बिदित नहिं के हू ।' मा० २.३१०.४
लोप : आ०ए०कवा० (सं० लुप्यते>प्रा० लुप्पइ = लोप्पइ)। लुप्त होता-होती है। 'तेरें हेरें लोप लिपि बिधिहू गनक की।' कवि० ७.२०
लोभ : सं०पु. (सं.)। लालच । अप्राप्त वस्तु की लिप्सा का तीव्र संवेदन दे० षड्वर्ग । मा० १.३२.६
968
_______________________________________________
लोभइ : लोभ ही, एकमात्र लोभ । 'लोभइ ओढ़न लोभइ डासन ।' मा० ७.४०.१
लोभहि : लोभ को । 'जिमि लोभहि सोषइ संतोषा ।' मा० ४.१६.३
लोमा : (१) लोभ । 'गुजत मधुप निकर मधु लोभा।' मा० ४.१३.१ (२) लुब्ध (प्रा० लुब्भ = लोब्भ) । लोभलीन, ललचाया, लुब्ध हुआ । 'विप्र चरन देखत मन लोभा। मा० १.१९९.६
लोभा, लोभाइ : आ.प्रए० । लोभयुक्त होता है; लुब्ध (मुग्ध) होता है । 'मन फिरि नहिं अनत लोभाइ ।' गी० ७.२१.१५
लोभाई : (१) लोभाइ। 'जहाँ जाइ मन तहँइ लोभाई ।' मा० १.२१३.१ (२) पूकृ० । लब्ध होकर । 'बरष पाँच तह रहउँ लोभाई ।' मा० ७.७५.४
लोभाउँगो : आ०भ०० उए । ललचाऊँगा । 'लघु लालच न लोभाउँगो।' गी० ५.३०.३
लोभाए : भूक०पु०ब० । लुब्ध किये, लोभ में डाले । 'मागहु बर बहु भाँति लोभाए।' मा० १.१४५.३
लोभागि : (लोभ+आगि) लोभरूपी अग्नि, तीव्र लालसा । विन० २०३.७
लोभादि : लोभ तथा अन्य (षड्वर्ग)। मा० ३.४३
लोभान : भूक०० । लुब्ध हुआ । 'मन सिय रूप लोभान ।' मा० १.२३१
लोभानी : भूकृ०स्त्री० । लुब्ध हुई। 'हरि बिरंचि हर पुर सोभा सब कोसलपुरी ... लोभानी ।' गी० १.४.६
लोभाने : भूक००ब० । लुब्ध हुए । 'एतेहु पर रुचि रूप लोभाने ।' कृ. ३८
लोभामरष : (लोभ+अमर्ष) लोभ तथा क्रोध । मा० ७.३८.२
लोभारे : वि०पुब० (सं० लोभकारक>प्रा० लोभारय) । लुभावने । 'नख सिख अंग लोभारे ।' गी० १.६१.२
लोभिहि : लोभी को । 'लोभिहि प्रिय जिमि दाम ।' मा० ७.१३० ख
लोभी : वि०० (सं० लोभिन्) । लालची। मा० १.२६७.३
लोभु : लोभ+कए । मा० १.४८ ख
लोभे : लोभाने । 'नव सुमन माल सुगंध लोभे मंजु गुंजत मधुकरा ।' गी० ७.१६.३
लोम : रोम (सं.)। विन० २८.१
लोमस : संपु० (सं० लोमश) । एक ऋषि जो अमर माने गये हैं। मा० ७.११०
लोयन : लोचन (प्रा० लोयण) । 'लोयन लाहु हमहि बिधि दीन्हा ।' मा० २.८६.३
लोयनन, नि, न्ह, न्हि : लोयन+संब० । नेत्रों (को) । 'ब्रह्मानंद हृदय, दरस-सुख लोयननि ।' गी० १.६१.४
लोल : वि.पु. (सं.)। (१) चञ्चल । 'राजत लोचन लोल ।' मा० १.२५.८ (२) लोलुप, लालची । 'भागु भागो लोभ लोल को।' कवि० ७.१५
_______________________________________________
969
लोलदिनेस : (दे० दिनेस) । लोलार्क (काशी में एक कुण्ड तीर्थ) । विन० २२.४
लोला : लोल । मा० १.२४३.४
लोलुप : वि० (सं०-लोलपीति इति लोलुप:)। हड़प जाने वाला, लुप्त करने का अतिशय इच्छुक; किसी प्रकार से वस्तु प्राप्त करने का अभिलाषी । माछ १.२६७.३
लोलपचारा : वि० (सं० लोलुपचार) । लोलुप आचरण करने वाला; हड़प जाने के लिए तत्पर । 'लोभी लंपट लोलुपचारा।' मा० २.१६८.३
लोलुपता : सं०स्त्री० (सं०) । हड़प लेने की प्रवृत्ति । 'इरिषा परुषाच्छर लोलुपता।' मा० ७.१०२.७
लोवा : सं०पू० (सं० लोपाक>प्रा० लोवाअ =सियार) । लोमड़ी। 'लोवा फिरि फिरि दरसु देखावा ।' मा० १.३०३.५
लोह : (क) सं०० (सं.)। (१) धातुविशेष । मा० २.१७६ (२) आयुध (लोहायुध)। (३) युद्ध । 'सनमुख लोह भरत सन लेऊँ।' मा० २.१६०.२ (ख) (सं० लोभ>प्रा. लोह) । लालच । 'तब तें बेसाह्यो दाम लोह कोह काम को।' कवि० ७.७०
लोहा : लोह।
लोहारिनि : संस्त्री० (सं० लोहकारिणी>प्रा० लोहारिणी) । लोहार जाति की स्त्री । रा०न० ५
लोहित : (१) वि. (सं०) । अरुणवर्ण, लाल । 'लोहित ललित लघु चरन कमल चारु ।' गी० १.१०.३ (२) सं०० (सं.)। मङ्गल ग्रह ।
लोहितपुर : मङ्गल ग्रह के नगर; मङ्गल-ग्रह-पिण्ड । 'प्रति मंदिर कलसनि पर भ्राहिं मनिगन दुति अपनी । मानहं प्रगटि बिपुल लोहितपुर पठइ दिये अवनी।' गी० ७.२०.३
लोहू : सं०० (सं० लोहित)। रक्त, रुधिर, खून । कवि० ६.४६
लोहे : लोह । आयुधों से, युद्ध में । 'लोहे ललकारि लरे हैं।' गी० ६.१३.१
लौं : अव्यय'। तक, पर्यन्त । 'सुत मानहिं मातु पिता तब लौं। अबलानन दीख नहीं जब लौं।' मा० ७.१०१.४
लौ : लय+कए । ध्यान, चाह, भाव, प्रेम । 'मिलहिं न राम कपट लो लाये।' विन० १२६.५
लौका : सं०० (सं० अलाब क) । लौकी का फल (तूंबा) । 'लोह ले लौका तिरा ।' मा० २.२५१ छं०
लौकिक : वि० (सं० लोके विहितो हितः प्रसिद्धो वा लोकिकः)। (१) लोक में प्रचलित । (२) लोकविहित । (३) लोक हित कर । 'तेहि श्रम यह लोकिक व्यवहारू ।' मा० २.८७.८ 'करि बैदिक लौकिक सब रीतीं।' मा० १.२२०.१
970
ल्याइ : पू० (लेइ+आइ) । ले आकर, लिवा कर, साथ लेकर । 'सुंदरि चलीं कोहबर ल्याइ के।' मा० १.३२६ छं०४
ल्याईं : (लेइ+आई) लेकर आई, साथ लाई । 'सुनत सुआसिनि सादर ल्याई ।'  मा० १.३२४.३
ल्याए : (लेइ+आए) लेकर आये, साथ लाये । 'मंगल सकल साजि सब ल्याए ।  मा० १.३१३.२
ल्यायो : (लेइ+आयो) । लेकर आया । 'अचल ल्यायो चलि के ।' कवि० ६.५५ 'अस कहि लछिमन कहुं कपि ल्यायो।' मा० ६.८४.५
ल्यावौं : (लेइ+आवौं) ले आऊँ, साथ लेकर आऊँ। 'जो लौं हौं ल्यावौं रघुबीरहि ।' गी० ५.१४.१
# व
वंदारु : वि० (सं०) । वन्दनाशील, प्रणतिशील । विन० ५४.६
वंदित : वन्दित । विन० ४६.५
वंदिनि : वि.स्त्री० । वन्दनीया, प्रणम्या। नर नाग असुर वंदिनि ।' विन० १७.१
वंदे : वन्दे । विन० १०.३
वंद्य : वि० (सं०) । वन्दनीय, स्तुत्य, प्रणम्य । विन० १२.२
वंश : सं.पु. (सं०) । (१) कुल । मा० ३.४ छं. (२) वेणु, बाँस ।
वंशाटवी : (वंश+अटवी)। कुल रूपी वेणु का वन । 'कसं वंशाटवी धूमकेतू ।' विन० ५२.७
वक्र : वि० (सं०) । (१) तिरछा । 'वक्र अवलोक।' विन: ५१.३ (२) कुटिल । मा० १ श्लोक ३
वचन : सं०० (सं०) । कथन, उक्ति । विन० ३८.३
वचांसि : (सं०) सं०ब० । वचन । 'न अन्यथा वचांसि मे।' मा० ७.१२२ ग
वज्र : सं०० (सं०) । (१) इन्द्र का आयुध विशेष । विन० ४६.७ (२) हीरा। 'द्विज वज़ दुति ।' विन० ५१.३ (३) मेघ की बिजली। (४) लोह । (५) वि० । सुदृढ, लोहतुल्य कठोर । वन तनु (वनाङ्गहनुमान् जी)।' विन० २५.७)
